19TH	W AH N AY N T IY EY CH
A	AH
A(2)	EY
ABLE	EY B AH L
ABOUT	AH B AW T
AGAINST	AH G EH N S T
AGAINST(2)	AH G EY N S T
AGO	AH G OW
ALL	AO L
ALONE,	AH L OW N
ALSO	AO L S OW
AN	AE N
AN(2)	AH N
AND	AH N D
AND(2)	AE N D
ANTIBODIES	AE N T IH B AA D IY Z
ANTIBODIES(2)	AE N T IY B AA D IY Z
ANTIBODIES(3)	AE N IH B AA D IY Z
ANTIBODY	AE N T IH B AA D IY
ANTIBODY(2)	AE N T IY B AA D IY
ANXIETY	AE NG Z AY AH T IY
ANY	EH N IY
ANYTHING	EH N IY TH IH NG
APPLIED	AH P L AY D
APPLYING	AH P L AY IH NG
ARE	AA R
ARE(2)	ER
AS	AE Z
AS(2)	EH Z
AT	AE T
BACK	B AE K
BE	B IY
BEAUTIFUL	B Y UW T AH F AH L
BECAUSE	B IH K AO Z
BECAUSE(2)	B IH K AH Z
BECAUSE(3)	B IH K AA Z
BEEN	B IH N
BEEN(2)	B AH N
BIOLUMINESCENT	B AY AH L AH M AH N EH S AH N T
BODY.	B AA D IY
BOTH	B OW TH
BOTTOM	B AA T AH M
BRAIN	B R EY N
BRAIN'S	B R EY N Z
BRAIN,	B R EY N
BRAINBOW	B R EY N B AW
BUT	B AH T
BY	B AY
CAJAL	K EY JH AH L
CALLED	K AO L D
CAN	K AE N
CAN(2)	K AH N
CELL	S EH L
CELL,	S EH L
CELLS	S EH L Z
CENTURY	S EH N CH ER IY
CHANGED	CH EY N JH D
CHEMICAL	K EH M IH K AH L
CIRCUITS	S ER K AH T S
CLEARS	K L IH R Z
COAT	K OW T
COLORS	K AH L ER Z
COLORS.	K AH L ER Z
COME	K AH M
COMES	K AH M Z
COMING	K AH M IH NG
COMPARE	K AH M P EH R
COMPLICATED	K AA M P L AH K EY T AH D
COMPONENTS	K AH M P OW N AH N T S
COMPUTER	K AH M P Y UW T ER
COMPUTER,	K AH M P Y UW T ER
COMPUTER.	K AH M P Y UW T ER
CONNECTED	K AH N EH K T IH D
CONNECTIONS	K AH N EH K SH AH N Z
CONSIDERED	K AH N S IH D ER D
CONTEXT	K AA N T EH K S T
COULD	K UH D
COURSE	K AO R S
CRACK	K R AE K
CRACKED	K R AE K T
CRITICAL	K R IH T IH K AH L
CUT	K AH T
DARKENING	D AA R K AH N IH NG
DARKENING(2)	D AA R K N IH NG
DATA	D EY T AH
DATA(2)	D AE T AH
DELIVER	D IH L IH V ER
DEPRESSION	D IH P R EH SH AH N
DESIGNING	D IH Z AY N IH NG
DETECT	D IH T EH K T
DEVELOPED	D IH V EH L AH P T
DIAGRAM	D AY AH G R AE M
DID	D IH D
DIFFERENT	D IH F ER AH N T
DIFFERENT(2)	D IH F R AH N T
DISEASES	D IH Z IY Z AH Z
DISEASES(2)	D IH Z IY Z IH Z
DO	D UW
DOES	D AH Z
DOES(2)	D IH Z
DOING	D UW IH NG
DON'T	D OW N T
DON'T(2)	D OW N
DRAWING	D R AO IH NG
DRUGS	D R AH G Z
ENGINEER	EH N JH AH N IH R
ENGINEERED	EH N JH AH N IY R D
ENOUGH	IH N AH F
ENOUGH(2)	IY N AH F
ENTIRE	IH N T AY ER
EVEN	IY V IH N
EVERYTHING	EH V R IY TH IH NG
EVOLVED	IH V AA L V D
EVOLVED(2)	IY V AA L V D
EXAMPLE	IH G Z AE M P AH L
EXPLANATORY	IH K S P L AE N AH T AO R IY
EYES	AY Z
FACT	F AE K T
FAMILIAR	F AH M IH L Y ER
FATHER	F AA DH ER
FEEBLE	F IY B AH L
FIRST	F ER S T
FLOWING	F L OW IH NG
FLUORESCENT	F L UH R EH S AH N T
FLUORESCENT(2)	F L AO R EH S AH N T
FOLLOWING	F AA L OW IH NG
FOR	F AO R
FOR(2)	F ER
FOR(3)	F R ER
FOREST	F AO R AH S T
FOREST(2)	F AO R IH S T
FORM	F AO R M
FORMLESS	F AO R M L AH S
FROM	F R AH M
FUNCTIONS	F AH NG K SH AH N Z
GAVE	G EY V
GENE	JH IY N
GENETICALLY	JH AH N EH T IH K L IY
GET	G EH T
GET(2)	G IH T
GLIMPSE	G L IH M P S
GLIMPSES	G L IH M P S IH Z
GLOW	G L OW
GLOWING	G L OW IH NG
GO	G OW
GOLGI	G OW L JH IY
GOTTEN	G AA T AH N
GOTTEN(2)	G AO T AH N
GRAY	G R EY
GREAT	G R EY T
GREATEST	G R EY T AH S T
GREEN	G R IY N
HAD	HH AE D
HAVE	HH AE V
HEARD	HH ER D
HENCHMEN	HH EH N CH M AH N
HERE	HH IY R
HEY	HH EY
HOW	HH AW
HUMAN	HH Y UW M AH N
HUMAN(2)	Y UW M AH N
I	AY
IDENTIFY	AY D EH N T AH F AY
IF	IH F
IMAGES	IH M AH JH AH Z
IMAGES(2)	IH M IH JH IH Z
IMAGINE	IH M AE JH AH N
IMMUNE	IH M Y UW N
IN	IH N
INDIVIDUAL	IH N D AH V IH JH AH W AH L
INDIVIDUALLY	IH N D IH V IH JH UW AH L IY
INDIVIDUALLY(2)	IH N D IH V IH JH AH L IY
INSIDE	IH N S AY D
INSTEAD	IH N S T EH D
INTERVENING	IH N T ER V IY N IH NG
INVADING	IH N V EY D IH NG
INVOLVES	IH N V AA L V Z
IS	IH Z
IT	IH T
IT'S	IH T S
ITS	IH T S
JELLYFISH	JH EH L IY F IH SH
JELLYFISH,	JH EH L IY F IH SH
JUST	JH AH S T
JUST(2)	JH IH S T
KEYBOARD	K IY B AO R D
KIND	K AY N D
LABELED	L EY B AH L D
LARGE	L AA R JH
LATE	L EY T
LATER	L EY T ER
LATER,	L EY T ER
LAUNCHED	L AO N CH T
LEAVE	L IY V
LIGHT	L AY T
LIKE	L AY K
LITTLE	L IH T AH L
LOOK	L UH K
LOOKING	L UH K IH NG
LOOKS	L UH K S
LOT	L AA T
LOT(2)	L AO T
LUCK	L AH K
MACHINERY	M AH SH IY N ER IY
MACHINERY(2)	M AH SH IY N R IY
MAKE	M EY K
MANY	M EH N IY
MICROSCOPE	M AY K R AH S K OW P
MILLIONS	M IH L Y AH N Z
MINDS	M AY N D Z
MODERN	M AA D ER N
MOLECULAR	M AH L EH K Y AH L ER
MOLECULES	M AA L AH K Y UW L Z
MOLECULES,	M AA L IH K Y UW L Z
MORE	M AO R
MOST	M OW S T
MOST(2)	M OW S
MOUSE	M AW S
MUCH	M AH CH
NATURAL	N AE CH ER AH L
NATURAL(2)	N AE CH R AH L
NATURE	N EY CH ER
NEED	N IY D
NERVE	N ER V
NEUROANATOMIST	N Y UH R AH N AE T AH M AH S T
NEURON.	N UW R AA N
NEURONS	N UH R AA N Z
NEURONS,	N UW R AA N Z
NEUROSCIENCE	N Y UH R OW S AY AH N S
NEUROSCIENTISTS	N Y UH R AH S IY N T AH S T S
NEW	N UW
NEW(2)	N Y UW
NO	N OW
NOBODY	N OW B AA D IY
NOBODY(2)	N OW B AH D IY
NOSE	N OW Z
NOT	N AA T
NOTHING	N AH TH IH NG
NOTION	N OW SH AH N
NOW	N AW
ODDLY	AA D L IY
OF	AH V
OLD	OW L D
ONE	W AH N
ONE(2)	HH W AH N
ONES	W AH N Z
ONLY	OW N L IY
ONTO	AA N T UW
ONTO(2)	AO N T UW
OPEN	OW P AH N
OPERATE	AA P ER EY T
OPERATE(2)	AO P ER EY T
OPTIC	AA P T IH K
OR	AO R
OR(2)	ER
ORDER	AO R D ER
OTHERS	AH DH ER Z
OUR	AW ER
OUR(2)	AW R
OUR(3)	AA R
OUT	AW T
OVER	OW V ER
OVERALL	OW V ER AO L
OWN	OW N
PALETTE	P AE L AH T
PARTICULAR	P ER T IH K Y AH L ER
PARTICULAR(2)	P AA T IH K Y AH L ER
PERCENT	P ER S EH N T
POPULAR	P AA P Y AH L ER
POWER	P AW ER
POWERFUL	P AW ER F AH L
PRODUCTS	P R AA D AH K T S
PRODUCTS(2)	P R AA D AH K S
PROTEIN	P R OW T IY N
PROTEIN,	P R OW T IY N
PROTEIN.	P R OW T IY N
PUT	P UH T
QUESTION	K W EH S CH AH N
QUESTION(2)	K W EH SH AH N
QUICKLY	K W IH K L IY
RAMON	R AH M OW N
RATHER	R AE DH ER
RATHER(2)	R AH DH ER
READY-MADE	R EH D IY M EY D
REALIZED	R IY AH L AY Z D
REALLY	R IH L IY
REALLY(2)	R IY L IY
REASON,	R IY Z AH N
RECENT	R IY S AH N T
RECOGNIZE	R EH K AH G N AY Z
REFINED	R AH F AY N D
REFINED(2)	R IH F AY N D
REPRESENTATIONS	R EH P R AH Z AH N T EY SH AH N Z
RESEARCH	R IY S ER CH
RESEARCHERS	R IY S ER CH ER Z
REVEALS	R IH V IY L Z
REVEALS(2)	R IY V IY L Z
RIGHT	R AY T
SANTIAGO	S AE N T IY AA G OW
SAY	S EY
SCENE	S IY N
SCIENTISTS	S AY AH N T IH S T S
SCIENTISTS(2)	S AY N T IH S T S
SCIENTISTS(3)	S AY N T IH S
SCIENTISTS(4)	S AY AH N T IH S
SCRATCH	S K R AE CH
SCREEN	S K R IY N
SEE	S IY
SEEM	S IY M
SERONTONIN	S AH R AA N T AH N AH N
SEROTONIN	S ER AH T OW N IH N
SEVERAL	S EH V ER AH L
SHAPE	SH EY P
SHOWING	SH OW IH NG
SHOWS	SH OW Z
SKULL	S K AH L
SLICE	S L AY S
SO	S OW
SOLUTIONS	S AH L UW SH AH N Z
SOME	S AH M
SOMEHOW	S AH M HH AW
SOMETIMES	S AH M T AY M Z
SORT	S AO R T
SPANISH	S P AE N IH SH
SPECIFIC	S P AH S IH F IH K
SPECIFIC(2)	S P IH S IH F IH K
SSRIS	S R IH Z
STAIN	S T EY N
STAIN,	S T EY N
STAINING	S T EY N IH NG
STAININGS	S T EY N IH NG Z
STAINS	S T EY N Z
STEADILY	S T EH D AH L IY
STRUCTURE	S T R AH K CH ER
SUBSTANTIALLY	S AH B S T AE N SH AH L IY
SUBSTRUCTURES	S AH B S T R AH K CH ER Z
SUDDENLY	S AH D AH N L IY
SYSTEM	S IH S T AH M
SYSTEM.	S IH S T AH M
TAKE	T EY K
TELL	T EH L
THAN	DH AE N
THAN(2)	DH AH N
THANK	TH AE NG K
THAT	DH AE T
THAT(2)	DH AH T
THAT'S	DH AE T S
THE	DH AH
THE(2)	DH IY
THEM	DH EH M
THEM(2)	DH AH M
THEM.	DH EH M
THERE	DH EH R
THERE'S	DH EH R Z
THESE	DH IY Z
THEY	DH EY
THEY'RE	DH EH R
THIN	TH IH N
THINGS	TH IH NG Z
THINKING	TH IH NG K IH NG
THIS	DH IH S
THIS,	DH IH S
THIS.	DH IH S
THOUGHT	TH AO T
THOUSAND	TH AW Z AH N D
THOUSAND(2)	TH AW Z AH N
TISSUE	T IH S Y UW
TISSUE(2)	T IH SH UW
TO	T UW
TO(2)	T IH
TO(3)	T AH
TODAY	T AH D EY
TODAY(2)	T UW D EY
TODAY,	T AH D EY
TOOL	T UW L
TOOLS	T UW L Z
TOTALLY	T OW T AH L IY
TRANSISTOR.	T R AE N Z IH S T ER
TRANSPORTERS	T R AE N S P AO R T ER Z
TREAT	T R IY T
TREES	T R IY Z
TURNS	T ER N Z
TWO	T UW
UNDER	AH N D ER
UNDERSTAND	AH N D ER S T AE N D
UNTIL	AH N T IH L
UP	AH P
US	AH S
US(2)	Y UW EH S
USE	Y UW S
USE(2)	Y UW Z
USED	Y UW Z D
USEFUL	Y UW S F AH L
USEFUL.	Y UW S F AH L
USING	Y UW Z IH NG
VARIANTS	V EH R IY AH N T S
VERY	V EH R IY
VIRUS	V AY R AH S
VISIBLE	V IH Z AH B AH L
VISUAL	V IH ZH AH W AH L
VISUALIZE	V IH ZH W AH L AY Z
WANT	W AA N T
WANT(2)	W AO N T
WANTED	W AO N T IH D
WAS	W AA Z
WAY	W EY
WAYS	W EY Z
WE	W IY
WERE	W ER
WHAT	W AH T
WHAT(2)	HH W AH T
WHAT'S	W AH T S
WHAT'S(2)	HH W AH T S
WHATEVER	W AH T EH V ER
WHATEVER(2)	HH W AH T EH V ER
WHEN	W EH N
WHEN(2)	HH W EH N
WHEN(3)	W IH N
WHEN(4)	HH W IH N
WHERE	W EH R
WHERE(2)	HH W EH R
WHICH	W IH CH
WHICH(2)	HH W IH CH
WHO	HH UW
WIDELY	W AY D L IY
WILL	W IH L
WILL(2)	W AH L
WIRING	W AY R IH NG
WITH	W IH DH
WITH(2)	W IH TH
WON'T	W OW N T
WORKS	W ER K S
WOULD	W UH D
Y	W AY
YEAR	Y IH R
YEARS	Y IH R Z
YIELDS	Y IY L D Z
YOU	Y UW
YOU'RE	Y UH R
YOU'RE(2)	Y UW R
